"filename", "language", "C++", "Markdown", "Shell Script", "YAML", "comment", "blank", "total"
"/home/chen/桌面/工具箱/Autodrive_Toolchain/README.md", "Markdown", 0, 5, 0, 0, 0, 5, 10
"/home/chen/桌面/工具箱/Autodrive_Toolchain/build.sh", "Shell Script", 0, 0, 4, 0, 0, 1, 5
"/home/chen/桌面/工具箱/Autodrive_Toolchain/clean_cache.sh", "Shell Script", 0, 0, 4, 0, 0, 1, 5
"/home/chen/桌面/工具箱/Autodrive_Toolchain/common/config_flags.cc", "C++", 6, 0, 0, 0, 8, 6, 20
"/home/chen/桌面/工具箱/Autodrive_Toolchain/common/config_flags.hpp", "C++", 5, 0, 0, 0, 0, 5, 10
"/home/chen/桌面/工具箱/Autodrive_Toolchain/common/logger.cc", "C++", 44, 0, 0, 0, 3, 11, 58
"/home/chen/桌面/工具箱/Autodrive_Toolchain/common/logger.hpp", "C++", 128, 0, 0, 0, 23, 25, 176
"/home/chen/桌面/工具箱/Autodrive_Toolchain/common/macros.hpp", "C++", 27, 0, 0, 0, 2, 8, 37
"/home/chen/桌面/工具箱/Autodrive_Toolchain/common/time_base.cc", "C++", 279, 0, 0, 0, 14, 75, 368
"/home/chen/桌面/工具箱/Autodrive_Toolchain/common/time_base.hpp", "C++", 118, 0, 0, 0, 6, 29, 153
"/home/chen/桌面/工具箱/Autodrive_Toolchain/common/time_utils.cc", "C++", 251, 0, 0, 0, 4, 22, 277
"/home/chen/桌面/工具箱/Autodrive_Toolchain/common/time_utils.hpp", "C++", 133, 0, 0, 0, 12, 40, 185
"/home/chen/桌面/工具箱/Autodrive_Toolchain/config_data/ReadMe.md", "Markdown", 0, 2, 0, 0, 0, 2, 4
"/home/chen/桌面/工具箱/Autodrive_Toolchain/gtest/common_test.cpp", "C++", 83, 0, 0, 0, 2, 17, 102
"/home/chen/桌面/工具箱/Autodrive_Toolchain/gtest/config_data/extrinsics.yaml", "YAML", 0, 0, 0, 13, 0, 1, 14
"/home/chen/桌面/工具箱/Autodrive_Toolchain/gtest/interface_test.cpp", "C++", 82, 0, 0, 0, 10, 14, 106
"/home/chen/桌面/工具箱/Autodrive_Toolchain/gtest/math_kalman_filter_test.cpp", "C++", 68, 0, 0, 0, 7, 15, 90
"/home/chen/桌面/工具箱/Autodrive_Toolchain/gtest/math_utils_test.cpp", "C++", 19, 0, 0, 0, 0, 3, 22
"/home/chen/桌面/工具箱/Autodrive_Toolchain/gtest/senser_data_test.cpp", "C++", 27, 0, 0, 0, 6, 5, 38
"/home/chen/桌面/工具箱/Autodrive_Toolchain/interface/DataConverter.cc", "C++", 211, 0, 0, 0, 0, 47, 258
"/home/chen/桌面/工具箱/Autodrive_Toolchain/interface/DataConverter.h", "C++", 47, 0, 0, 0, 14, 12, 73
"/home/chen/桌面/工具箱/Autodrive_Toolchain/interface/DataProcessor.cc", "C++", 38, 0, 0, 0, 0, 5, 43
"/home/chen/桌面/工具箱/Autodrive_Toolchain/interface/DataProcessor.h", "C++", 57, 0, 0, 0, 4, 18, 79
"/home/chen/桌面/工具箱/Autodrive_Toolchain/interface/DataReader.cpp", "C++", 268, 0, 0, 0, 14, 26, 308
"/home/chen/桌面/工具箱/Autodrive_Toolchain/interface/DataReader.h", "C++", 23, 0, 0, 0, 8, 14, 45
"/home/chen/桌面/工具箱/Autodrive_Toolchain/interface/DataWriter.cc", "C++", 51, 0, 0, 0, 2, 7, 60
"/home/chen/桌面/工具箱/Autodrive_Toolchain/interface/DataWriter.h", "C++", 15, 0, 0, 0, 0, 6, 21
"/home/chen/桌面/工具箱/Autodrive_Toolchain/main.cpp", "C++", 13, 0, 0, 0, 0, 4, 17
"/home/chen/桌面/工具箱/Autodrive_Toolchain/math_utils/curve_fitting.hpp", "C++", 51, 0, 0, 0, 3, 7, 61
"/home/chen/桌面/工具箱/Autodrive_Toolchain/math_utils/kalman_filter.hpp", "C++", 99, 0, 0, 0, 13, 32, 144
"/home/chen/桌面/工具箱/Autodrive_Toolchain/math_utils/matrix_operations.hpp", "C++", 29, 0, 0, 0, 18, 9, 56
"/home/chen/桌面/工具箱/Autodrive_Toolchain/only_test.sh", "Shell Script", 0, 0, 4, 0, 0, 1, 5
"/home/chen/桌面/工具箱/Autodrive_Toolchain/run.sh", "Shell Script", 0, 0, 5, 0, 0, 1, 6
"/home/chen/桌面/工具箱/Autodrive_Toolchain/run_test.sh", "Shell Script", 0, 0, 7, 0, 0, 1, 8
"/home/chen/桌面/工具箱/Autodrive_Toolchain/sensor_data/Infrastructure.hpp", "C++", 96, 0, 0, 0, 15, 27, 138
"/home/chen/桌面/工具箱/Autodrive_Toolchain/sensor_data/Infrastructure.inl", "C++", 228, 0, 0, 0, 16, 35, 279
"/home/chen/桌面/工具箱/Autodrive_Toolchain/sensor_data/pose_data.hpp", "C++", 86, 0, 0, 0, 11, 19, 116
"/home/chen/桌面/工具箱/Autodrive_Toolchain/task.md", "Markdown", 0, 18, 0, 0, 0, 20, 38
"Total", "-", 2582, 25, 24, 13, 215, 576, 3435